000000L00000000000000000000000000000000000000000000000L000000000000000000000000000000000000000000000000000R0000000000000
000000000000M00000000000000ASBTA0000000000000000000000000000000000000000000000M00000000ASBBT0000000000000000000000000000
00000020000000UASBT0000000022222000000000000000BAAB002200000000000022200000ASTB00000000222220AA000000000000BATSU00000000
000000002000000222200000M00000000000000BT0000002222000000000002220000000000222200000M00000000000000000000002222000000000
0000000000000000000000000000000000M00002200000000000AA0000000G00000000000000SS0000000000000000M000SS000022000000SS000000
0000000000220000000M00022200000002200000000R0000000A00A000000000002200000R0S00S00002220R000002222SU0S00000000U0000000000
00000000000000022222000000000000000000000000000000022220000000BAST000000000222220000000000000000000002200000000222200000
000000000000000000000022000000000000000000000000220000000000002222000000022000000000000000000000000000000220000000022000
0000000000M0000000000000000000000M000000000000000000000000000000000000M000000000M000000000000M00000000000000000000000000
YYYYYYYYYYYYYYYYYYYYYYYYYYYYYYYYYYYYYYY000YYYYYYYY00000YYYYYYY00000YYYYYYYYYYYYYYYYYY00YYYYYYYYYYYYYYYYY00YYYYYYYYYYYYYY