000000000000000000000000000000000000000000000000000000000000000000000000000000000000L00000000000000000000000000000000000
0000000000000000000000000000000ASTA00000000000BSTA00000000AS0000000ASS0000000000000000000000AS000000000000ASBT0000000000
000000000000000000000M0000000004444000000000004444000000004400000004400000000000MR00400000044440000000000044440000000000
000000000S000000444444400000000000000M00000000000000000000004000000000440000444444400000000000000M0000000000000000000000
000000S0S000ASTBA0000000000SAT004444440000B0000000BAST00000000400000400000000000000000000000440B440000000000000AS0000000
00000S00000G44444000000000044400U00000000000R0000044440B0000000440000000004440000ASTBA00000000B0B0000000U000044440000000
00000000000000000000000000000000000000004400000000000B000B00000000044000000000000444440000000B0000B000000000000000000000
0000044444000000000000000000000000000004400000004400B00000B000000000000000000000000000000000B044400B00000000000000000000
000000000000000000M00000000000000000M00000000000000000000000000000000000000000M00000000000000000M00000000000000000000000
YYYYYYYYYYYYYYYYYYYYYYYYY00YYYYYYYYYYYYYYYYYYYYYY00YYYYYYYYYYYY00YYYYYYYYYYYYYYYYY00YYYYYYYYYYYYY00YYYYYYYYYYYYYYYYYYYYY