000000000000000000000000000000000000000000000000000000000000000000000000000000000000000000000000000000000000000000000000000000000000
0000000SA000000000000000000BSBTB0000000000000000000000000000000000000000000000000000000ASBTS0000000000000U00000000000000000000000000
00000003300000000000000000033333000000000000000BTBS00R0000000AAAS0000000000ABRS0000000033333000000000000000ASBS000000000000000000000
00000000033000000000000ASB00000000000000000000033330000000000333300000000003333000000000000000000000000000033330000A0000000000000000
00000000000000M0000000000M00000000B000000000BD00000SBTB00033000000000M00000000000000000000000000000000000000M000003330SS000000000000
000000000000333G00000M03330U00000330000G000S00S000000000M00000000033330000000UASTM00000000000000R00000000333300000000033000000000000
000000000000000003333300000000000000000000A0000A000003333000000SBSB00000033003333300000000000003330003300000000000333000000000000000
000000333003300000000000000000000000000000000003330000000000003333000000000000000000000000333000000000000000000000000000000000000000
000000000000000000000000000000000M000000000000000000000000000000000M000000000000M00000000000000000000000M000000000000000000000000000
YYYYYYY00000YYYYYYYYYYYYY000YYYYYYYYYYYYYYYYYYYYY0000YYYYYYYYYYYYYYYYYYY00YYYYYYYYYYYYYYYY000YYYYYYYYYYYYYYY0000YYYYYYYYYYYYYYYYYYYY