000000000000000000000000000000000000000000000000000000000000L00000000000000000000000000000000000000000000000000000000000000000000000
0000000000000000000000U0000BSBTB0000000000000000000000000000000U000000000000000000000BSBAB00000000BAB0000000000000000000000000000000
000000000000000TBSB00000000XXXXX000000000000000BTBS000000000000000000000B00B00O000000XXXXX0000000000000SBAST00000G000000000000000000
000000000000000XXXX00000000000000B0000000000000XXXX0000000000X00BTST0000XXXX0A00000X0000000000000000000XXXXX000000000000000000000000
0000000000000000000000000000000000B0000000000000000SBTB00000000000000000000000A000X00000000000000X0X00000AA000XX00000000000000000000
000000R00000000000000M0XXX000000000B000G0000XX0000000000M0000000XXXX00U0000000000M00000XX0000R0000000000A00A00000000M000000U00000000
00000000000000000XXXXX000000000000000000000000000000XXXXX0000000BSBT000000000XXXXX000000000000000000000A0000A0000XXXX000000000000000
00000000000000000000000000000000000000000000000X00000000000000XXXX000000000000000000000000000000000000000000000000000000000000000000
0000000000M0000000000000000000000M000000000000000000000000000000000000M000000000M000000000000M0000000000M000000000000000000000000000
YYYYYYYYYYYYYYYYYYYYYYYYYY000YYYYYYYYYYYYYYYYYYYYYYY00000YYYYYYYYYYYYYYYYYYYYYYYYYY00YYYYYYYYYYYY0Y0YYYYYYYYYYYYYYYYYYYYYYYYYYYYYYYY