000000000000000000000000000SBAST00000A0000000000000000000000000000000000000000000000000000000000U00000000M00000000000000000000000000
0000000000000000000000U00000000M000000000000000000000001110000000U0000000000000000000000000M0000000000111100000000000000000000000000
000000000000000000M0000000011111000000000000000BTBS0G0000000000000000000000ASU000000000111110000000000000000000M0G000000000AST000000
0000000000000001111000000010000000000000000000011110000000011100000000000001111000AS0000000000000000M000000111110000000ASBT111000000
0000000000000000000000000M00000000M0000000000000000000001100000000ASBT00000000000011000000000000011110000000000000000001111000000000
000000R0000000000ASBTS011100000U0110000G00000000000000M000000000001111000000000000000000011000AST00000000111100000M00000000U00000000
000000000000000001111100000000000000000000000000000001111000000000000000000001111100000000000011100000110000000001111100000000000000
000000000000000000000000000000000000000000000000000000000000001111000000000000000000000000000000001111000000000000000000000000000000
0000000000M0000000000000000000000M0000000000000M0000000000000000000000M000000000M000000000000M0000000000M000000000000000000000000000
YYYYYYYYYYYYYYYYY00YYYYYYYY00YYYYYYYYYYYYYYYYYYYYYYYYYYYYYY00Y0YYYYYYYYYYYYYYYYYYYYYYY00YYYYYYYYYYYYYYYYYYYYYYYYYY0000YYYYYYYYYYYYYY